MMMMMMMMMMMMMM
M......MM....M
M..X.K.MM.MX.M
M.......O....M
MMMMMMMMOMMMMM
.......MMM....