.MMMMM
.M...MMM
MM.MX.KM
M.O.X..M
MOOOMXMM
M.M.X.M
M..M...M
MM...MMM
.MMMMM