MMMMMMMMMM
MOOOOOOOOM
MM....MM.M
MM.X.....M
MMMKM..MMMMMMMMMM
M........MM.....M
M...........X...M
M.......XMM..XX.M
MMM..MM..MM....MM
MMMM.....MMMMMMMM
MM.X.XX.........M
MM....M.........M
MMMMMMMMMMMMMMMMM