MMMMMMMMMMMMMMMMMMMM
M....M..M.M..M..M..M
M.KM.M.MM.X...X...MM
MMMM.M....M..M.X...M
M....M.MM.MX.MM.MM.M
M......X...X...X...M
MOOMMMXXMM.XMMX.MM.M
MOOMOM..M.X...X.M..M
MOOOOM.XX...MMX.MMMM
MOOOOM..MMMMM......M
MOOOMMM........MM..M
MMMMMMMMMMMMMMMMMMMM