MMMMM.....
M   MMMMMM
M      OOM
M   OOOOOM
MMMMMMMOMM
M  X X KM.
M X X XXM.
M  X X  M.
M       M.
MMMMMMMMM.