.........MMMM
.MMMMMMMMM..MM
MM..X......X.MMMMM
M...MM.MM...MMOOOM
M.MXX.X.XXMXMMOOOM
M.M...K...M...OOOM
M..XM.MMMXX...OOOM
M.X..XX..X.MMOOOOM
MMMX.......MMMMMMM
..M..MMMMMMM
..MMMM