MMMMMM.....MMMM
M....MMMMMMM..MMMMM
M...XM..M..X..M...M
M..X..X..X.M.X.X..M
MMX.X...M.KM.X....M
M..X.MMMMMMMMMMM.MM
M.M...MOOOOOOOM.XM
M.MM..M.OOOOOOM..M
M.M...XOOOOOOOOX.M
M.M.X.MOOOO.OOM..M
M..X.XMMMMXMMMM.XM
M.X...MMM.X...X..MM
M.X.....X.X..X....M
MM.MMMMMM.X.MMMMM.M
M.........M.......M
MMMMMMMMMMMMMMMMMMM