MMMMMMMMMMMMMMMMMMMM
MK.....MMM...M..M..M
M.M.M..M..X..X.....M
MMMMM.....M.X.XMXM.M
MOMOOM....MMX.X....M
MOOOOO....X...M...MM
MOOOOO....MMMXMMXMMM
MOMOOM....X....M...M
MMMMM.....M..MX..X.M
MMMMM..M..X....X.X.M
MMMMM..M..M..M..M..M
MMMMMMMMMMMMMMMMMMMM