..MMMMMMMM
..M...M..M
..M...XO.M
.MMMXMM..M
.M.XOMM.MM
MM.XOO...M
M..MXM...M
M.OK.MMMMM
MM...M
.MMMMM