MMMMMMMMMMMMMMMMMMMM
M.....M..M...MK....M
M.M..........MM....M
M..X..M...M...MM...M
M.MM.MMMMMMM...MM..M
M........M..M...M..M
M....M.......M.....M
MMM..XXXM....M.....M
MOO..M..M....M.XM..M
MOO.....M.......X..M
MOOMMM..M....M..M..M
MMMMMMMMMMMMMMMMMMMM