MM.K.MMMM
M..X....M
MM.MMMMMM
MM......M
M..M....M
M...MM.MM
M.....MMM
MMM.M...M
M.......M
M..MMM..M
M......OM
MMMMMMMMM