MMMMMMMMMMMM
MM.....MM..M
MM...X...X.M
MMMM.MM.XX.M
M...X.M....M
M.XXX.M.MMMM
M...M.M.X.MM
M..M..M..X.M
M.XM.XM....M
M...OOM.MMMM
MMMMOO.X.MKM
MOOOOOM.XM.M
MMOOOOM..X.M
MMMOOMM....M
MMMMMMMMMMMM