MMMMM
MO..MMMMMMMMMMM
M...MK......XOM
MM.MM........OM
.M.....O.....OM
.M.X......MXXXM
.MM..MMMMMM...M
..MMMM....M...M
..........M..MM
..........MMMM