MMMMMMMMMMMMMMMMMMMM
MOO...M...M........M
MOO...M...M........M
MOO...MX..M....X...M
MOO...MX......X.X..M
MOO.X.....M....X...M
MOO...M...M........M
MMMMMMMM.MMMM.MMMMMM
MKX.......M.X.X....M
M..............X.X.M
M.........M........M
MMMMMMMMMMMMMMMMMMMM