MMMMMMMM
MMMMMKOM
MMMMOXXM
MMMM X M
MMM OM M
MMM    M
MMM  MMM
MMMMMMMM