MMMMMMMMM
MM  K  MM
M  XXX  M
M X X X M
M  X X  M
M X X X M
M MXMXM M
M MOOO  M
M  OOOM M
M MMOMMMM
M MOOO  M
M  OOOM M
M MMM M M
M       M
MMMMMMMMM