MMMMMMM
M.....MMMMMMMMMM
M.....M....M..MM
M.X...M...X.X..M
M..X..M..X.MM..M
M.XX..MMX.X....M
MM.M..MM.MMMMMMM
MM.M..MM....OOOM
M..MX.......OOOM
M...XX......OOOM
M.....MMKM..OOOM
MMMMMMMMMMMMMMMM