.MMMM
.M.KMM
MM.O.MMM
M.XXXO.M
MOOXOM.M
M.X.X..M
MM.O..MM
.MMMMMM