.....MMMMMMM
.....M..M..M
.....M..XX.M
MMMMMM.XM..M
MOOOMMM.M..MM
MO..M..X.M..M
MO....X.XX.M
MO..M..X.M..M
MOOOMMM.M..MM
MMMMMM.X...M
.....M..M..M
.....MMMMMMM