..........MMMMMMM
..........M..OOOM
......MMMMM..OOOM
......M......O.OM
......M..MM..OOOM
......MM.MM..OOOM
.....MMM.MMMMMMMM
.....M.XXX.MM
.MMMMM..X.X.MMMMM
MM...MX.X...M...M
MK.X..X....X..X.M
MMMMMM.XX.X.MMMMM
.....M......M
.....MMMMMMMM
