.MMM..MMMMMMMMMMMMM
MMKMMMM.......M...M
M.XX...XX..X.X.OOOM
M..XXXM....X..MOOOM
M.X...M.XX.XX.MOOOM
MMM...M..X....MOOOM
M.....M.X.X.X.MOOOM
M....MMMMMM.MMMOOOM
MM.M..M..X.X..MOOOM
M..MM.M.XX.X.XMMOOM
M.OOM.M..X......MOM
M.OOM.M.XXX.XXX.MOM
MMMMM.M.......M.MOM
....M.MMMMMMMMM.MOM
....M...........MOM
....MMMMMMMMMMMMMMM