.MMMMMMMMMMMMM
.M....M..MM..M
.MXXX.M.XX..XMM
.M.X..M..OOOO.M
.M..X..MXOMMO.M
.M..M.XM.OOOO.M
MMX.X..MXOMMO.M
M.X..X.KXOOOO.M
M...MMM..MMMMMM
MMMMM.MMMM