MMMMMMMMMMMMMMMMMMMM
MMOOO...MM.M....M..M
MOOOO.........X.MM.M
MOOOOM.M.MXMMMX....M
MOOOM....M.......M.M
MMOM..MX.M.....XMM.M
M..M..M.X.X.MMM..X.M
M.....X..X.M..M.MM.M
MM.M.MM.MXXM.XM..M.M
M..M...X.X.M......MM
M....M.....M..M...KM
MMMMMMMMMMMMMMMMMMMM