MMMMMMMMMMMMM
M...........M
M.....X.....M
M...M...M...M
M...........M
M.M.......M.M
M..MMOOOMM..M
M....MMM....M
M....XKX....M
MMMMMMMMMMMMM