MM  K  MM
M  X X  M
M X X X M
M  X X  M
M X X X M
M  X X  M
M MMXMM M
M  OOO  M
M  OOOM M
M MMOMMMM
M MOOO  M
M MOOOM M
M   M   M
MM     MM
MMMMMMMMM