MMMMMMMMMMMMMMMMMMMM
MMMMMKMMMOMMOOOMM..M
MMMMMX..OOMOOOM....M
MMMM....OOOOOOM..X.M
MMM..X.MOOOOOMM.M.MM
MM..XXM.MMMMM..X.X.M
MM.XM.X....MM..XX..M
MM..M..M....M.X..X.M
MM...XX.MMM.MXMM...M
MM.XM......X.X..X.MM
MMM....M....M....MMM
MMMMMMMMMMMMMMMMMMMM