MMMMMMMMMMMMMMMMMMMM
M................MMM
M.XM...X.MM..X....MM
M....XMMM....M.XX.MM
MOMMM.....X.X.MM..MM
MOOOM..M..M....MX..M
MOOMMXXMMMM.X..M...M
MOOOM......X.MM..MMM
MOOOX..MMM..M....M.M
MMOO..XM..MM...MMK.M
MMMOM..............M
MMMMMMMMMMMMMMMMMMMM
