...MMMMMMMMM
..MM...MM..MMMMMM
MMM.....M..M....MMM
M..X.MX.M..M..OOO.M
M.M.XMKXMM.M.MOMO.M
M..M.MX..M....O.O.M
M.X....X.M.M.MOMO.M
M...MM..MMX.X.O.O.M
M.X.M...M..MXMOMO.M
MM.X..X...X..XOOO.M
.MX.MMMMMM....MM..M
.M..M....MMMMMMMMMM
.MMMM