MMMMMMMMMMMM
MOO..M.....MMM
MOO..M.X..X..M
MOO..MXMMMM..M
MOO....K.MM..M
MOO..M.M..X.MM
MMMMMM.MMX.X.M
  M.X..X.X.X.M
  M....M.....M
  MMMMMMMMMMMM






