.....MMMMMM
.....M...OM
....MM..MMM
....M...M
MMMMMXMXMMMM
M....X...X.M
M..X.K.MX..M
MM.....M.MMM
.MMMM.OM.MMM
....MOOO.O.M
....MMMMMMMM