MMMMMMMMMMMMM
M...M.M.....M
M.XXM.M.X.X.M
M..X........M
M.......MMMMM
MMMM........M
M....M....MXM
M....M....M.M
MMM..MMMM...M
M....MOOO...M
M...KMOOO...M
MMMMMMMMMMMMM