MMMMMMMMMMMMMM
M...M........M
M.M.M........M
M.X..........M
M.MMMM..K..O.M
M.M..M.......M
M.M.OM.......M
M.M..M.......M
M.MM.MMMMM...M
M..M.....M...M
M..M..M..M...M
M..MMMM.MM.MMM
M..MMMM.MM.MMM
M..M..X.MM...M
M..M.M..MM...M
M....MMMMMM.MM
M..M.........M
M..MMMM.X....M
MOMMMMM......M
MMMMMMMMMMMMMM