MMMMMMMMMMMM.MMMMMM
M...M....M.MMMOOOOM
M...XXM...K..OOOOOM
M...M.MMM...M.OOOOM
MM.MM.MMM..M..OOOOM
.M.X.X.....M.M.MMMM
.M..X.XMM..M......M
MMMM.M..MMMM.M.MM.M
M..M.MX...MM.M....M
M.X..X..M.MM.M...MM
M.M.X.X....M.M...M
M..X.MM.MM.M.MMMMM
M.XX.....XX..M
MM.MM.MMM.X..M
.M....M.M....M
.MMMMMM.MMMMMM