.....MMMMMMMM
..MMMM......MMMMMM
..M....MM.X.X...KM
..M.MM.MMXMX.X.XMM
MMM.OOOOOOM..XX.MM
M...OOOOOOM..M...M
M.M.OOOOOOMX..X..M
M.MXOOOOOO.XXM.X.M
M...MMM.MMMX..X.MM
MMM..X..X..X..X.M
..M..X..X..X..X.M
..MMMMMM...MMMMMM
.......MMMMM