MMMMMMM.....MMMMMM
M.....MMMMMMM....M
M..X..MOOOOOM....M
MMMM..M.....M.XM.M
M.....M..K..M..M.MM
M..MMMM.....MMMM..M
M.................M
MMMMMMM.....MMMM..M
.M..M.......M....MM
.M..........M..X.M
.M.XMMMMMXMMMMM..M
.M..M...M........M
.MMMM...MMMMMMMMMM