MMMMMMMMMMMMM
M..X.K..M...M
MM......MX..M
MM..........M
M.XM...XMMMMM
M..MMM....OOM
M.........OOM
MMMMMMMMMMMMM