MMMMMMMMMMMMMMMMMMMM
M....KMM......M...MM
M....MM....X....X.MM
M..MMMOOOOM.M.M..MMM
M...MOOOOM.M.M.X...M
MMM.MOOOM..M.......M
MM..MMOM.....X...X.M
MM..X.X.MMM..M.M.MMM
MM.X.......M.M.X...M
MMMM.X..XM.M.M.M.X.M
MMMM.........M.M..MM
MMMMMMMMMMMMMMMMMMMM