...MMMMMM
...M    M
MMMM    M
MOOO M MM
MOOO M M.
MOMOKMXM.
M  XXM M.
MMM    M.
..M X MM.
.MM M  MM
.M  X X M
.M X X  M
.MM     M
..MMMMMMM