MMMMMMMMMMMMMMMMMMMMM
M..X...............OM
M..X...MMMMMMMMMMMMOM
M..X..MMMMMMMMMM...OM
M..X.MMMMMMMMMM.K..OM
M...X..............OM
MMMMMMMMMMMMMMM..MMMM
..............MMMM