...MMMMMMMMMM
MMMMOOOOOO..M
M...OOOOOM..M
M..MOOOOOO.MM
MM.MMMMXMMXM
MKX..X.X...MMM
M.XX....MM...M
M.M..XXMM..M.M
M...X..M.XX..M
M..X..X...MX.M
MMMM...M.X.X.M
...M...M.....M
...MMMMMMMMMMM