..............MMMMM
..............M...M
.........MMMMMM.X.M
.........MM...M.X.M
.........MM.....X.M
MMMMMMMMMMM..MMMMMM
M.............X...M
M.XM...........X..M
M..M......MKMM....M
MMMMOOOOOOMMMMMMMMM
...MMMMMMMM