MMMMMMMMMMMMMMMMMMMM
M..M......M...M...MM
M.XM.X.X.MMOOOX..X.M
M..X..M.MMOOOOM.X..M
M.MM.X.MMOOOOM...X.M
M.X....MOOOOMM.X...M
M.XMM..MOOOM.......M
M...XXXMMXMM..MMM.MM
M.M.M..M...M..M....M
M.X.M..X..MM.......M
M....M....MK.......M
MMMMMMMMMMMMMMMMMMMM