MMMMMMMMMMMMMMMMMMMM
M.....MMMOOMMM.....M
M.XX..MMMOOMMM..XK.M
M..M.MMOOOOOOM..X..M
M.....MOOOOOOM..X..M
MMMM..MMMOOMMMMMMX.M
M...XXX.MOOM....M..M
M.XM...X..X..XX.MX.M
M..M..MM.X..MM..M..M
M.X....X.MM.X....X.M
M..M..MM....MM..M..M
MMMMMMMMMMMMMMMMMMMM