.MMMMM.MMMM..
.M   M MO MM.
MM X MMMOX MM
M  X MOO    M
M  XKMO  XX M
MM XMMO MM  M
.M X  OXM X M
.MMMMOOOM   M
....MMMMMMMMM