.....MMMMMM
...MMM.MMOM
.MMM..KMM.M
.MMMO..MM.M
MMMO..MMM.M
M...M.MMM.M
M..X....M.M
MM.M..X.MXM
.MXM..O...M
.M...MMMMMM
.MMMMM