MMMMMMMMMMMMMMMMMMMM
M..M.....M..MM....MM
M.XM...X.M.....MM..M
M.X..X..MOOM.....X.M
M.X.X..MOOOOM...M.MM
M.XM..MOOOOOOMMM.X.M
M...M..MOOOOM..MX..M
M.X..MMMMOOM...M...M
MM.X...MM.M.M.X..XMM
MMM.X....XMKX.XM...M
MMMM...M.......M...M
MMMMMMMMMMMMMMMMMMMM