MMMMMM...
MOO  M...
MOO  M...
MOO kMM..
MMMXOOM..
M   MMMMM
M X     M
M  M X  M
M XXX X M
M  X  MMM
MM  MMMM.
.MMMM....