.....MMMMMMMMMMM
.....M..O..M...M
.....M.MO....K.M
.MMMMM.MMOOM.MMMM
MM..M.OOMMM.....MMM
M.X.MOOO...X.M..X.M
M....OO.MM..MM.MM.M
MMMMXMMXM.X.M...M.M
..MM.M....MX.XX.M.M
..M..X.M.M..M.XMM.M
..M...............M
..M..MMMMMMMMMMM..M
..MMMM.........MMMM