MMMMMMMMMMMMMMMMMMMM
M.M.....M..........M
M.......X..MM.MMM.MM
MMMMM..MM...X..X...M
MMOOMM..M.M.X.M.M..M
MOOOO..X.....MMXM.MM
MOOOO..XMMMMM...MXMM
MMOOM.M..M...M..X..M
MMMOM.M..X...X..M.KM
MM..X..X.M...M..MMMM
MM.......MMMMMMMMMMM
MMMMMMMMMMMMMMMMMMMM