MMMMM
M...MM
M.X..MMMMMMMMM
MM.M.M.......MMMMMM
MM.M...XMXMK..M...M
M..M......X.M...X.M
M..MMM.MMMMMMMMM.MM
M..MM.OO.OOOOO.M.MM
MM.MM..O.OO.O..M.MM
M.XMMMMMMMMMM.MMX.M
M..X...X..X....X..M
M..M...M...M...M..M
MMMMMMMMMMMMMMMMMMM