MMMMMMMM..
M OOM  M..
M OOM XMMM
M  MM    M
MM X   X M
.M MM  MMM
.M   XMM
.MMM  M
...MK M
...MMMM