MMMMMMMMMMMMMMMMMMMM
M......OOOOM....MMMM
M......OOOO........M
M.M.MMMMMMMMMM.....M
M.MX...M......MMMOOM
M..X...MXXMMM...MOOM
M.X.MMM.X...X...MOOM
M.X.M...X.X.M..MMOOM
M..M..XX.M.X.MM...MM
MKMM.XM..X..X.....MM
MM.......MM...M..MMM
MMMMMMMMMMMMMMMMMMMM