.....MMMMMMMMM
.....M.......M
.....M..XMXM.M
.MMMMMM..M.X.M
.M...M.X..X..M
MM.X.....MMM.M
M...MXMMMM...M
M....X.MMM.MMM
MMMMMOO.KM.MM
...MOOOX.XX.M
...MOOOM....M
...MOOOMMMMMM
...MMMMM

