MMMMM.MMMM
M...M.M..M
M..XMMMK.M
MM.X..X..M
.M.OOOOX.M
.MM..M..MM
..MMMMMMM