MMMMMM..MMMM
M...X...MK.M
M...X......M
M..........M
MMMMM......M
M..X.......M
MM.M...MMMMM
M......M
M.X....MMMMM
M...M..OOOOM
MMMMMMMMMMMM