MMMMMMMMMMMMMMMMMMMM
M..M..MM....M...KMMM
MM....X....M.XMMM..M
MMXM.X.MMXM.X.X....M
M...XM....X......MMM
M.MM...X.MMM..MOOOOM
M.M.XM.M.M.M.MOOOOMM
M....X.X.M..MOOOOMMM
MMX.MMM..X.MOOOOMMMM
M..M.X........MMMMMM
M......M.M....MMMMMM
MMMMMMMMMMMMMMMMMMMM