MMMMMMMMM
MOOO....M
MM.M....M
M.......M
M.......M
M.......M
M...MMMMM
M.......M
M.......M
M....MM.M
MMMM.MK.M
M....MMMM
M.......M
M..M....M
M..M.XX.M
M..M..X.M
MMMMMMMMM