..MMMM
..M..MMMMMMMMMMM
..M....X...X.X.M
..M.XM.X.M..X..M
..M..X.X..M....M
MMM.XM.M..MMMM.M
MKMX.X.X..MM...M
M....X.MXM...M.M
M...X....X.X.X.M
MMMMM..MMMMMMMMM
..M......M
..M......M
..MOOOOOOM
..MOOOOOOM
..MOOOOOOM
..MMMMMMMM
