MMMMMMMMMMMMMMMM
MMMMM...MM.MMMMM
MM..X....MMM...M
MM.XKX.X....X..M
MM.MXMMMMMMMM.MM
MM.M..X..M.....M
MM.M X.X.M.M...M
MM.M..XM.M.MMMMM
M..MM....M.....M
M....X.M.MMM...M
MMMMM.MM..MOOOOM
M....X.....OOOOM
M.........MOOOOM
MMMMMMMMMMMMMMMM